111111211111
111112211111
111122211111
111222211111
112222211111
111112111111
122222222221
222222222222
022222222220
111111111111
111111111111
111111111111
