000000000000
001100001100
012210012210
122221122221
122222222221
122222222221
012222222210
001222222100
000122221000
000012210000
000001100000
000000000000