01111221111
01112222111
01122222211
01222222221
02222222222
02222222222
01112222111
01112222111