000000000000
000001100000
000012210000
000122221000
001222222100
012222222210
012222222210
001222222100
000122221000
000012210000
000001100000
000000000000