1122112211
1122112211
1122112211
1122112211
1111111111
1111111111
2111111112
2211111122
1221111221
1122112211
1111221111
1111111111