11111211111
11112221111
11122222111
11222222211
12222222221
22222222222
11112221111
11112221111