1111221111
1112222111
1122222211
1222222221
2222222222
2222222222
1112222111
1112222111