00000000000
00001100000
00012210000
00122221000
01222222100
12222222210
12222222210
01222222100
00122221000
00012210000
00001100000
00000000000