00000000000
00110000110
01221001221
12222112222
12222222222
12222222222
01222222221
00122222210
00012222100
00001221000
00000110000
00000000000