01111211111
01112221111
01122222111
01222222211
02222222221
02222222222
01112221111
01112221111